no; id_pinjam; nik; nama; periode; angsuran; utang; bayar; saldo
2280;85;7422;EREN YEAGER;2024-06;5000000;40000000;5000000;35000000
2281;85;7422;EREN YEAGER;2024-07;5000000;40000000;10000000;30000000
2282;85;7422;EREN YEAGER;2024-08;5000000;40000000;15000000;25000000
2283;85;7422;EREN YEAGER;2024-09;5000000;40000000;20000000;20000000
2284;85;7422;EREN YEAGER;2024-10;5000000;40000000;25000000;15000000
2285;85;7422;EREN YEAGER;2024-11;5000000;40000000;30000000;10000000
2286;85;7422;EREN YEAGER;2024-12;5000000;40000000;35000000;5000000
2287;85;7422;EREN YEAGER;2025-01;5000000;40000000;40000000;0
